%%%%%%%%%%%%%%%%%%%%%%
%                    %
%    B               %
%                    %
%          %         %
%                    %
%                    %
%        %           %
%                    %
%                   B%
%%%%%%%%%%%%%%%%%%%%%%
