%%%%%%%%%%%%%%%
%   %$$$$$%   %
%$$$%$$$$$%$$$%
%$$$$$$$$$$$$$%
%%$ $$%$%$$ $%%
%$$$%$$$$$%$$$%
%$$$$$$$$$$$$$%
%%$ $$%$%$$ $%%
%%$ $$%$%$$ $%%
%$$$$$$$$$$$$$%
%$$$%$$$$$%$$$%
%%$ $$%$%$$ $%%
%$$$$$$$$$$$$$%
%   %$$$$$%   %
% B %$$$$$% B %
%%%%%%%%%%%%%%%
