%%%%%%%%%%%
% B       %
%         %
%         %
%       V %
%%%%%%%%%%%