%%%%%%%%%%%%%%
%  $ R       %
%B $         %
%            %
%            %
%            %
%            %
%            %
%%%%%%%%%%%%%%
